1111111111111111111111111111111111111
11C0000000000000000000000000000000001
111E000000000000000000000000111000001
111C0000C0000000000000000000001100001
11000000000000000C0000000000011000001
1100000000000000000000000110000000001
1100000000000000000000000C00000000001
1100000000000000000000000000001100001
1111111110000000000000000000001100001
1100000000000000000000000000001111001
1100000000000000000000000000001100001
1100000000000000000000000000001100001
1000000000000000000000P00000000000001
1000000000000000000000000000001000001
1111111111111111111111111111111111111
