1111111111111111111111111111111111
1P00000000000001000001C00000000001
101001C100100000101001000000010101
1010010010101010001001000000010101
1000000000001000000C00000000000011
100000C0000000000000000000000C0001
1000000000000010000000001000000001
1100000010000000011000000000100001
1111111111111111111111111111111111
