1111111111111111111
11C0000000000000011
111E000000000000011
111C0000C0000000001
1100000000000000001
1100000000000000001
110000000000000C001
1100000000000000001
1111111110000000001
1100000000000000001
1100000000000000001
1100000000000000001
1000000000000000P01
1000000000000000001
1111111111111111111
