11111111
10010000C1
100001111101
1P0011E00000001
1111111111111
