111111111111111111111111111111
1P00000000000000000000C0011111
111111111111111111111110000111
111111111111111111111100000001
111111111111111100000000000011
1111111111C0000000000000111111
100000000000000000111111111111
1000000000000000C0000000000001
1111111100000000000000000000C1
100000000000000000000000000001
100000000000000000000000000001
100000000000000000000000000E01
111111111111111111111111111111
