1111111111111111111111111111111111
1P00000000000001000001000000000001
1010010100100000101001000000010101
1010010010101010001001000000010101
1000000000001000000000000000000011
10000000000000000000000000000E0001
1000000000000010000000001000000001
1100000010000000011000000000100001
1111111111111111111111111111111111
